144;66;66;9;0;0;0;0;0;0
1056;0;0;3504;66;66;66;219;66;9
3504;66;66;1581;0;0;0;1056;0;1581
1056;0;0;3504;66;66;66;2886;66;516
2304;66;66;516;0;0;0;0;0;0
