144;9;0;0;0;0;0;0;0
1056;2304;9;144;66;66;9;0;0
2304;9;2304;1581;0;0;1056;0;0
0;2304;9;2304;9;0;1056;0;0
0;0;2304;9;2304;9;3504;66;9
0;0;0;2304;9;2304;1581;0;1056
0;0;0;0;2304;219;516;0;1056
0;0;0;0;0;1056;0;0;1056
0;0;0;0;0;2304;66;66;516
